Andrews, Julie 	BENG (HONS) COMPUTER SECURITY AND FORENSICS F/T
Arliss, George 	BENG (HONS) COMPUTER NETWORKS AND DISTRIBUTED SYSTEMS F/T
Bancroft, Anne 	BENG (HONS) COMPUTER SECURITY AND FORENSICS F/T
Barrymore, Lionel 	BENG (HONS) INTERNET COMPUTING F/T
Bates, Kathy 	BENG (HONS) COMPUTING F/T
Baxter, Warner 	BENG (HONS) COMPUTING F/T
Beery, Wallace 	BENG (HONS) COMPUTING F/T
Benigni, Roberto 	BENG (HONS) COMPUTER SECURITY AND FORENSICS F/T
Bergman, Ingrid 	BENG (HONS) COMPUTER SECURITY AND FORENSICS F/T
Bergman, Ingrid 	CERTIFICATE OF HIGHER EDUCATION IN COMPUTING F/T
Berry, Halle 	MENG SOFTWARE ENGINEERING F/T
Bogart, Humphrey 	BENG (HONS) WEB BASED SYSTEMS F/T
Booth, Shirley 	BENG (HONS) COMPUTING F/T
Borgnine, Ernest 	BENG (HONS) SOFTWARE ENGINEERING F/T
Brando, Marlon 	BSC (HONS) INTERACTIVE MEDIA DESIGN F/T
Brando, Marlon 	BSC (HONS) DIGITAL MEDIA F/T
Bridges, Jeff 	BSC (HONS) INTERACTIVE MEDIA DESIGN F/T
Brody, Adrien 	BENG (HONS) COMPUTER SECURITY AND FORENSICS F/T
Brynner, Yul 	BSC (HONS) INTERACTIVE MEDIA DESIGN F/T
Bullock, Sandra 	BENG (HONS) COMPUTER SECURITY AND FORENSICS F/T
Burstyn, Ellen 	BSC (HONS) DIGITAL MEDIA F/T
C. Scott, George 	BENG (HONS) COMPUTING F/T
Cage, Nicolas 	BENG (HONS) COMPUTER SECURITY AND FORENSICS F/T
Cagney, James 	BENG (HONS) COMPUTING F/T
Carney, Art 	BSC (HONS) DIGITAL MEDIA F/T
Christie, Julie 	BENG (HONS) COMPUTER SECURITY AND FORENSICS F/T
Colbert, Claudette 	BENG (HONS) SOFTWARE ENGINEERING F/T
Colman, Ronald 	BENG (HONS) COMPUTING F/T
Cooper, Gary 	BSC (HONS) INTERACTIVE MEDIA DESIGN F/T
Cooper, Gary 	BENG (HONS) COMPUTING F/T
Cotillard, Marion 	BENG (HONS) COMPUTING F/T
Crawford, Broderick 	CERTIFICATE OF HIGHER EDUCATION IN COMPUTING F/T
Crawford, Joan 	BSC (HONS) INTERACTIVE MEDIA DESIGN F/T
Crosby, Bing 	BENG (HONS) COMPUTER SECURITY AND FORENSICS F/T
Crowe, Russell 	BSC (HONS) BUSINESS INFORMATION SYSTEMS F/T
Davis, Bette 	BSC (HONS) INTERACTIVE MEDIA DESIGN F/T
Davis, Bette 	BENG (HONS) SOFTWARE ENGINEERING F/T
Day-Lewis, Daniel 	BENG (HONS) SOFTWARE ENGINEERING F/T
Day-Lewis, Daniel 	BENG (HONS) COMPUTER SECURITY AND FORENSICS F/T
De Havilland, Olivia 	BENG (HONS) COMPUTER SECURITY AND FORENSICS F/T
De Havilland, Olivia 	BENG (HONS) COMPUTER SECURITY AND FORENSICS F/T
De Niro, Robert 	BENG (HONS) COMPUTER NETWORKS AND DISTRIBUTED SYSTEMS F/T
Donat, Robert 	BENG (HONS) COMPUTER SECURITY AND FORENSICS F/T
Douglas, Michael 	BENG (HONS) INTERNET COMPUTING F/T
Dressler, Marie 	BENG (HONS) COMPUTING F/T
Dreyfuss, Richard 	BENG (HONS) COMPUTING F/T
Dunaway, Faye 	BENG (HONS) COMPUTING F/T
Duvall, Robert 	BENG (HONS) COMPUTER SECURITY AND FORENSICS F/T
Field, Sally 	CERTIFICATE OF HIGHER EDUCATION IN COMPUTING F/T
Field, Sally 	MENG SOFTWARE ENGINEERING F/T
Finch, Peter 	BENG (HONS) WEB BASED SYSTEMS F/T
Fletcher, Louise 	BENG (HONS) COMPUTING F/T
Fonda, Henry 	BENG (HONS) SOFTWARE ENGINEERING F/T
Fonda, Jane 	BSC (HONS) INTERACTIVE MEDIA DESIGN F/T
Fonda, Jane 	BSC (HONS) DIGITAL MEDIA F/T
Fontaine, Joan 	BSC (HONS) INTERACTIVE MEDIA DESIGN F/T
Foster, Jodie 	BENG (HONS) COMPUTER SECURITY AND FORENSICS F/T
Foster, Jodie 	BSC (HONS) INTERACTIVE MEDIA DESIGN F/T
Foxx, Jamie 	BENG (HONS) COMPUTER SECURITY AND FORENSICS F/T
Gable, Clark 	BSC (HONS) DIGITAL MEDIA F/T
Garson, Greer 	BENG (HONS) COMPUTING F/T
Gaynor, Janet 	BENG (HONS) COMPUTER SECURITY AND FORENSICS F/T
Guinness, Alec 	BENG (HONS) COMPUTING F/T
Hackman, Gene 	BSC (HONS) DIGITAL MEDIA F/T
Hanks, Tom 	BENG (HONS) COMPUTER SECURITY AND FORENSICS F/T
Hanks, Tom 	BENG (HONS) SOFTWARE ENGINEERING F/T
Harrison, Rex 	BENG (HONS) COMPUTING F/T
Hayes, Helen 	BSC (HONS) INTERACTIVE MEDIA DESIGN F/T
Hayward, Susan 	BENG (HONS) COMPUTING F/T
Hepburn, Audrey 	CERTIFICATE OF HIGHER EDUCATION IN COMPUTING F/T
Hepburn, Katharine 	BSC (HONS) DIGITAL MEDIA F/T
Hepburn, Katharine 	BENG (HONS) COMPUTER SECURITY AND FORENSICS F/T
Hepburn, Katharine 	BSC (HONS) INTERACTIVE MEDIA DESIGN F/T
Heston, Charlton 	BSC (HONS) INTERACTIVE MEDIA DESIGN F/T
Hoffman, Dustin 	BSC (HONS) DIGITAL MEDIA F/T
Hoffman, Dustin 	BENG (HONS) SOFTWARE ENGINEERING F/T
Holden, William 	BENG (HONS) COMPUTER SECURITY AND FORENSICS F/T
Holliday, Judy 	BENG (HONS) COMPUTER SECURITY AND FORENSICS F/T
Hopkins, Anthony 	BENG (HONS) COMPUTER SECURITY AND FORENSICS F/T
Hunt, Helen 	BSC (HONS) INTERACTIVE MEDIA DESIGN F/T
Hunter, Holly 	BSC (HONS) INTERACTIVE MEDIA DESIGN F/T
Hurt, William 	BENG (HONS) COMPUTING F/T
Irons, Jeremy 	BSC (HONS) COMPUTING F/T
Jackson, Glenda 	BENG (HONS) COMPUTER NETWORKS AND DISTRIBUTED SYSTEMS F/T
Jackson, Glenda 	BENG (HONS) WEB BASED SYSTEMS F/T
Jannings, Emil 	CERTIFICATE OF HIGHER EDUCATION IN COMPUTING F/T
Jones, Jennifer 	BSC (HONS) INTERACTIVE MEDIA DESIGN F/T
Keaton, Diane 	BSC (HONS) COMPUTING F/T
Kelly, Grace 	BSC (HONS) COMPUTING F/T
Kidman, Nicole 	BSC (HONS) INTERACTIVE MEDIA DESIGN F/T
Kingsley, Ben 	BSC (HONS) INTERACTIVE MEDIA DESIGN F/T
Lancaster, Burt 	BENG (HONS) COMPUTING F/T
Lange, Jessica 	BENG (HONS) COMPUTER SECURITY AND FORENSICS F/T
Laughton, Charles 	BSC (HONS) DIGITAL MEDIA F/T
Leigh, Vivien 	BENG (HONS) MOBILE COMPUTING F/T
Leigh, Vivien 	BENG (HONS) COMPUTER SECURITY AND FORENSICS F/T
Lemmon, Jack 	BENG (HONS) EMBEDDED COMPUTER SYSTEMS F/T
Loren, Sophia 	BENG (HONS) INTERNET COMPUTING F/T
Lukas, Paul 	BENG (HONS) SOFTWARE ENGINEERING F/T
MacLaine, Shirley 	BSC (HONS) INTERACTIVE MEDIA DESIGN F/T
Magnani, Anna 	BENG (HONS) COMPUTER SECURITY AND FORENSICS F/T
March, Fredric 	BENG (HONS) COMPUTING F/T
March, Fredric 	BSC (HONS) BUSINESS INFORMATION SYSTEMS F/T
Marvin, Lee 	BENG (HONS) COMPUTING F/T
Matlin, Marlee 	BSC (HONS) INTERACTIVE MEDIA DESIGN F/T
McDormand, Frances 	BSC (HONS) INTERACTIVE MEDIA DESIGN F/T
McLaglen, Victor 	BSC (HONS) INTERACTIVE MEDIA DESIGN F/T
Milland, Ray 	BENG (HONS) COMPUTER SECURITY AND FORENSICS F/T
Minnelli, Liza 	CERTIFICATE OF HIGHER EDUCATION IN COMPUTING F/T
Mirren, Helen 	BENG (HONS) COMPUTER SECURITY AND FORENSICS F/T
Muni, Paul 	BENG (HONS) COMPUTER NETWORKS AND DISTRIBUTED SYSTEMS F/T
Murray Abraham, F. 	BENG (HONS) COMPUTER SECURITY AND FORENSICS F/T
Neal, Patricia 	BENG (HONS) INTERNET COMPUTING F/T
Newman, Paul 	BENG (HONS) COMPUTING F/T
Nicholson, Jack 	BENG (HONS) COMPUTING F/T
Nicholson, Jack 	BENG (HONS) COMPUTING F/T
Niven, David 	BENG (HONS) COMPUTER SECURITY AND FORENSICS F/T
Olivier, Laurence 	BENG (HONS) COMPUTER SECURITY AND FORENSICS F/T
Pacino, Al 	CERTIFICATE OF HIGHER EDUCATION IN COMPUTING F/T
Page, Geraldine 	MENG SOFTWARE ENGINEERING F/T
Paltrow, Gwyneth 	BENG (HONS) WEB BASED SYSTEMS F/T
Peck, Gregory 	BENG (HONS) COMPUTING F/T
Penn, Sean 	BENG (HONS) SOFTWARE ENGINEERING F/T
Penn, Sean 	BSC (HONS) INTERACTIVE MEDIA DESIGN F/T
Pickford, Mary 	BSC (HONS) DIGITAL MEDIA F/T
Poitier, Sidney 	BSC (HONS) INTERACTIVE MEDIA DESIGN F/T
Rainer, Luise 	BENG (HONS) COMPUTER SECURITY AND FORENSICS F/T
Rainer, Luise 	BSC (HONS) INTERACTIVE MEDIA DESIGN F/T
Roberts, Julia 	BENG (HONS) COMPUTER SECURITY AND FORENSICS F/T
Robertson, Cliff 	BSC (HONS) DIGITAL MEDIA F/T
Rogers, Ginger 	BENG (HONS) COMPUTING F/T
Rush, Geoffrey 	BENG (HONS) COMPUTER SECURITY AND FORENSICS F/T
Sarandon, Susan 	BENG (HONS) COMPUTING F/T
Schell, Maximilian 	BSC (HONS) DIGITAL MEDIA F/T
Scofield, Paul 	BENG (HONS) COMPUTER SECURITY AND FORENSICS F/T
Seymour Hoffman, Philip 	BENG (HONS) SOFTWARE ENGINEERING F/T
Shearer, Norma 	BENG (HONS) COMPUTING F/T
Signoret, Simone 	BSC (HONS) INTERACTIVE MEDIA DESIGN F/T
Smith, Maggie 	BENG (HONS) COMPUTING F/T
Spacek, Sissy 	BENG (HONS) COMPUTING F/T
Spacey, Kevin 	CERTIFICATE OF HIGHER EDUCATION IN COMPUTING F/T
Steiger, Rod 	BSC (HONS) INTERACTIVE MEDIA DESIGN F/T
Stewart, James 	BENG (HONS) COMPUTER SECURITY AND FORENSICS F/T
Streep, Meryl 	BSC (HONS) BUSINESS INFORMATION SYSTEMS F/T
Streisand, Barbra 	BSC (HONS) INTERACTIVE MEDIA DESIGN F/T
Swank, Hilary 	BENG (HONS) SOFTWARE ENGINEERING F/T
Swank, Hilary 	BENG (HONS) SOFTWARE ENGINEERING F/T
Tandy, Jessica 	BENG (HONS) COMPUTER SECURITY AND FORENSICS F/T
Taylor, Elizabeth 	BENG (HONS) COMPUTER SECURITY AND FORENSICS F/T
Taylor, Elizabeth 	BENG (HONS) COMPUTER SECURITY AND FORENSICS F/T
Theron, Charlize 	BENG (HONS) COMPUTER NETWORKS AND DISTRIBUTED SYSTEMS F/T
Thompson, Emma 	BENG (HONS) COMPUTER SECURITY AND FORENSICS F/T
Tracy, Spencer 	BENG (HONS) INTERNET COMPUTING F/T
Tracy, Spencer 	BENG (HONS) COMPUTING F/T
Voight, Jon 	BENG (HONS) COMPUTING F/T
Washington, Denzel 	BENG (HONS) COMPUTING F/T
Wayne, John 	BENG (HONS) COMPUTER SECURITY AND FORENSICS F/T
Whitaker, Forest 	BENG (HONS) COMPUTER SECURITY AND FORENSICS F/T
Winslet, Kate 	CERTIFICATE OF HIGHER EDUCATION IN COMPUTING F/T
Witherspoon, Reese 	MENG SOFTWARE ENGINEERING F/T
Woodward, Joanne 	BENG (HONS) WEB BASED SYSTEMS F/T
Wyman, Jane 	BENG (HONS) COMPUTING F/T
Young, Loretta 	BENG (HONS) SOFTWARE ENGINEERING F/T
